1111111111111111
1CE0000C00CC00P1
1111111111111111
